1111111111
1010001001
1010N01001
1010001001
1111111111