1111111111
1000000001
1111111111
1000000001
1111111111
1000W00001
1111111111

1111111111
1000000001
1111111111
1000000001
1111111111

1111111111
1000000001
1111111111
1000000001
1111111111
1000000001
1111111111

1111111111
1000000001
1111111111