1111111111
1100000001
10010N0101
1010000001
1111111111
