 111111111 
1001 10001111
1001100001
1000010011
10001W11 1
1111111111