 111111111 
1001 10001111
1001100001
1000000011
10000W01  1
1111111111