1111111111
1100E00001
1000100001
1010000001
1111111111
