111111111111111
101010101010101
1101010101010101
101010101010101
1101010101010101
101 101N101 101
1101010101010101
101010101010101
1101010101010101
101010101010101
1101010101010101
1111111111111111